{
  "width": 5,
  "height": 5,
  "start": [0, 0],
  "end": [4, 4],
  "tiles": [
    [1, 1, 0, 1],
    [1, 0, 0, 1],
    [1, 0, 1, 0],
    [1, 0, 0, 0],
    [1, 1, 0, 0],

    [0, 1, 0, 1],
    [0, 0, 1, 1],
    [1, 1, 1, 0],
    [0, 1, 0, 1],
    [0, 1, 0, 1],

    [0, 0, 0, 1],
    [1, 0, 1, 0],
    [1, 0, 1, 0],
    [0, 1, 0, 0],
    [0, 1, 0, 1],

    [0, 1, 0, 1],
    [1, 1, 0, 1],
    [1, 1, 0, 1],
    [0, 1, 0, 1],
    [0, 1, 0, 1],

    [0, 0, 1, 1],
    [0, 1, 1, 0],
    [0, 0, 1, 1],
    [0, 1, 1, 0],
    [0, 1, 1, 1]
  ]
}
